0,0,0,0,0,0,0,0,0,0,0,0,0,0,0,0,0,0,0,0
0,2,2,2,2,2,2,6,6,6,6,6,6,2,2,2,2,2,2,0
0,2,2,2,2,2,2,6,6,3,2.9.true,6,6,2,2,2,2,2,2,0
0,2,2,2,2,2,2,6,6,2.9.true,2.9.true,6,6,2,2,2,2,2,2,0
0,2,2,2,2,2,2,6,6,6,6,6,6,2,2,2,2,2,2,0
0,2,2,1,1,1,1,7,7,4,5.9.true,7,7,1,1,1,1,2,2,0
0,2,2,1,1,1,1,7,7,5.9.true,5.9.true,7,7,1,1,1,1,2,2,0
0,2,2,1,1,1,1,7,7,7,7,7,7,1,1,1,1,2,2,0
0,2,2,1,1,1,1,7,7,7,7,7,7,1,1,1,1,2,2,0
0,2,2,1,1,1,1,1,1,1,1,1,1,1,1,1,1,2,2,0
0,2,2,1,1,1,1,1,1,1,1,1,1,1,1,1,1,2,2,0
0,2,2,1,1,1,1,1,1,1,1,1,1,1,1,1,1,2,2,0
0,2,2,2,2,2,2,2,1,1,1,1,2,2,2,2,2,2,2,0
0,2,2,2,2,2,2,2,5,5,5,5,2,2,2,2,2,2,2,0
0,0,0,0,0,0,0,0,0,0,0,0,0,0,0,0,0,0,0,0