0,0,0,0,0,0,0,0,0,0,0,0,1,1,1,0,0,0,0,0,0,0,0,0,0,0,0
0,6,6,6,6,6,6,6,6,6,6,6,6,6,6,6,6,6,6,6,6,6,6,6,6,6,0
0,6,2,6,6,2,6,6,2,6,6,2,6,6,6,2,6,6,2,6,6,2,6,6,2,6,0
0,6,6,6,6,6,6,6,6,6,6,6,6,6,6,6,6,6,6,6,6,6,6,6,6,6,0
0,6,6,6,6,6,6,6,6,6,6,6,6,6,6,6,6,6,6,6,6,6,6,6,6,6,0
0,6,2,6,6,6,6,6,6,6,6,6,6,6,6,6,6,6,6,6,6,6,6,6,2,6,0
0,6,6,6,6,3,6,6,3,6,6,3,6,6,6,3,6,6,3,6,6,3,6,6,6,6,0
0,6,6,6,6,6,6,6,6,6,6,6,6,6,6,6,6,6,6,6,6,6,6,6,6,6,0
0,6,2,6,6,5,6,6,6,6,6,6,6,6,6,6,6,6,6,6,6,5,6,6,2,6,0
0,6,6,6,6,5,6,6,6,6,6,6,6,6,6,6,6,6,6,6,6,5,6,6,6,6,0
0,6,6,6,6,5,5,5,5,5,5,5,6,6,6,5,5,5,5,5,5,5,6,6,6,6,0
0,6,2,6,6,5,5,5,5,5,5,5,6,6,6,5,5,5,5,5,5,5,6,6,2,6,0
0,6,6,6,6,5,6,6,6,6,6,6,6,6,6,6,6,6,6,6,6,5,6,6,6,6,0
0,6,6,6,6,5,6,6,6,4,6,6,6,6,6,6,6,4,6,6,6,5,6,6,6,6,0
0,6,2,6,6,5,6,6,6,6,6,6,6,6,6,6,6,6,6,6,6,5,6,6,2,6,0
0,6,6,6,6,5,6,6,6,4,6,6,6,6,6,6,6,4,6,6,6,5,6,6,6,6,0
0,6,6,6,6,5,6,6,6,6,6,6,6,6,6,6,6,6,6,6,6,5,6,6,6,6,0
0,6,2,6,6,5,6,6,6,4,6,6,6,6,6,6,6,4,6,6,6,5,6,6,2,6,0
0,6,6,6,6,5,6,6,6,6,6,6,6,6,6,6,6,6,6,6,6,5,6,6,6,6,0
0,6,6,6,6,5,6,6,6,4,6,6,6,6,6,6,6,4,6,6,6,5,6,6,6,6,0
0,6,2,6,6,5,6,6,6,6,6,6,6,6,6,6,6,6,6,6,6,5,6,6,2,6,0
0,6,6,6,6,5,6,6,6,4,6,6,6,6,6,6,6,4,6,6,6,5,6,6,6,6,0
0,6,6,6,6,5,6,6,6,6,6,6,6,6,6,6,6,6,6,6,6,5,6,6,6,6,0
0,6,2,6,6,5,6,6,6,4,6,6,6,6,6,6,6,4,6,6,6,5,6,6,2,6,0
0,6,6,6,6,5,6,6,6,6,6,6,6,6,6,6,6,6,6,6,6,5,6,6,6,6,0
0,6,6,6,6,5,6,6,6,4,6,6,6,6,6,6,6,4,6,6,6,5,6,6,6,6,0
0,6,2,6,6,5,6,6,6,6,6,6,6,6,6,6,6,6,6,6,6,5,6,6,2,6,0
0,6,6,6,6,5,6,6,6,4,6,6,6,6,6,6,6,4,6,6,6,5,6,6,6,6,0
0,6,6,6,6,5,6,6,6,6,6,6,6,6,6,6,6,6,6,6,6,5,6,6,6,6,0
0,6,2,6,6,5,6,6,6,4,6,6,6,6,6,6,6,4,6,6,6,5,6,6,2,6,0
0,6,6,6,6,5,6,6,6,6,6,6,6,6,6,6,6,6,6,6,6,5,6,6,6,6,0
0,6,6,6,6,5,6,6,6,4,6,6,6,4,6,6,6,4,6,6,6,5,6,6,6,6,0
0,6,2,6,6,5,6,6,6,6,6,6,6,6,6,6,6,6,6,6,6,5,6,6,2,6,0
0,6,6,6,6,5,5,5,5,5,5,5,5,5,5,5,5,5,5,5,5,5,6,6,6,6,0
0,6,6,6,6,5,6,6,6,6,6,6,6,6,6,6,6,6,6,6,6,5,6,6,6,6,0
0,6,2,6,6,5,6,6,6,6,6,6,6,6,6,6,6,6,6,6,6,5,6,6,2,6,0
0,6,6,6,6,5,6,6,6,6,3,6,6,6,6,6,3,6,6,6,6,5,6,6,6,6,0
0,6,6,6,6,5,6,6,6,6,6,6,6,6,6,6,6,6,6,6,6,5,6,6,6,6,0
0,6,2,6,6,5,6,6,6,6,6,6,6,6,6,6,6,6,6,6,6,5,6,6,2,6,0
0,6,6,6,6,5,6,6,6,6,3,6,6,6,6,6,3,6,6,6,6,5,6,6,6,6,0
0,6,6,6,6,5,6,6,6,6,6,6,6,6,6,6,6,6,6,6,6,5,6,6,6,6,0
0,6,2,6,6,5,6,6,6,6,6,6,6,6,6,6,6,6,6,6,6,5,6,6,2,6,0
0,6,6,6,6,5,5,5,5,5,5,5,6,6,6,5,5,5,5,5,5,5,6,6,6,6,0
0,6,6,6,6,5,5,5,5,5,5,5,6,6,6,5,5,5,5,5,5,5,6,6,6,6,0
0,6,2,6,6,5,6,6,6,6,6,6,6,6,6,6,6,6,6,6,6,5,6,6,2,6,0
0,6,6,6,6,6,6,6,6,6,6,6,6,6,6,6,6,6,6,6,6,6,6,6,6,6,0
0,6,6,6,6,3,6,6,3,6,6,3,6,6,6,3,6,6,3,6,6,3,6,6,6,6,0
0,6,2,6,6,6,6,6,6,6,6,6,6,6,6,6,6,6,6,6,6,6,6,6,2,6,0
0,6,6,6,6,6,6,6,6,6,6,6,6,6,6,6,6,6,6,6,6,6,6,6,6,6,0
0,6,6,6,6,6,6,6,6,6,6,6,6,6,6,6,6,6,6,6,6,6,6,6,6,6,0
0,6,2,6,6,2,6,6,2,6,6,2,6,6,6,2,6,6,2,6,6,2,6,6,2,6,0
0,6,6,6,6,6,6,6,6,6,6,6,6,6,6,6,6,6,6,6,6,6,6,6,6,6,0
0,0,0,0,0,0,0,0,0,0,0,0,0,0,0,0,0,0,0,0,0,0,0,0,0,0,0